ki	き₁
kwi	き₂
gi	ぎ₁
gwi	ぎ₂
pi	ぴ₁
pwi	ぴ₂
bi	び₁
bwi	び₂
mi	み₁
mwi	み₂
kye	け₁
ke	け₂
gye	げ₁
ge	げ₂
pye	ぺ₁
pe	ぺ₂
bye	べ₁
be	べ₂
mye	め₁
me	め₂
kwo	こ₁
ko	こ₂
gwo	ご₁
go	ご₂
swo	そ₁
so	そ₂
zwo	ぞ₁
zo	ぞ₂
two	と₁
to	と₂
dwo	ど₁
do  ど₂
nwo	の₁
no	の₂
mwo	も₁
mo	も₂
ywo	よ₁
yo	よ₂
rwo	ろ₁
ro	ろ₂
